WWWWWWWWWW
WS  M  thW
WG WWWW GW
1H WS   GW
WG WGGG GW
WG WS M GW
WG WWWW GW
W    M   W
Wk t B   W
WWWWWWWW0W
