WWWWWWWWWW
WS GGG  SW
W WW WW sW
W WF B M W
W WW WW  W
WGGGGGGGGW
WtWW WW tW
W W  TW  W
W  HGG BMW
WWW1WWWWWW
