WWWWWWWWWW
W F  S  FW
WS  W    W
W  WB    0
W WB  h  W
W GG    MW
W    WW  W
W    W   W
W   HWM  W
WWWW1WWWWW
