WWWWWWWWWW
WF   GGG W
W  M  s  W
WWWWW    W
WM GGBGG W
W  GBM G W
1H Gk BG W
W WGGGtG W
WsW  h   W
WWW0WWWWWW