WWWWWWWW1W
Ws M BGGHW
WWWWW GGGW
W   B GGGW
W   WWW  W
WBM  S  FW
WGGGGG   0
WGGGGGT  W
WGGGGGM  W
WWWWWWWWWW