WWWW0WWWWW
WGGG GGGGW
WG    S GW
WWWWW   GW
WG FW   GW
WG  W   GW
WG H    GW
WG   h  GW
WGGGGGGGGW
WWWWWWWWWW
